0,1,1,1,1,1,1,1,1,1,1,1,1,1,1,1,1,1,1,2
3,4,4,4,4,4,4,4,4,4,4,4,4,4,4,4,4,4,4,5
3,4,4,4,4,4,4,4,4,4,4,4,4,4,4,4,4,4,4,5
6,7,7,7,7,7,7,7,7,7,7,7,7,7,7,7,7,7,7,8
6,7,7,7,7,7,7,7,7,7,7,7,7,7,7,7,7,7,7,8
6,7,7,7,7,7,7,7,7,7,7,7,7,7,7,7,7,7,7,8
6,7,7,7,7,7,7,7,7,7,7,7,7,7,7,7,7,7,7,8
6,7,7,7,7,7,7,7,7,7,7,7,7,7,7,7,7,7,7,8
6,7,7,7,7,7,7,7,7,7,7,7,7,7,7,7,7,7,7,8
6,7,7,7,7,7,7,7,7,7,7,7,7,7,7,7,7,7,7,8
9,10,10,10,10,10,10,10,10,7,7,10,10,10,10,10,10,10,10,11
12,12,12,12,12,12,12,12,12,12,12,12,12,12,12,12,12,12,12,12